1111111111111
10100001000C1
10000E01C00C1
10PC110000001
1000000000001
10000E0000001
1111111111111